####################
#                  #
# ######### ########
#   ### ########   #
#   # # #          #
#                  #
####################